TST = "countries/Test.txt"
CEN = "countries/Central Asian Nomads.txt"
ACR = "countries/Acronesia.txt"
KAI = "countries/Kaiserreich.txt"
YOR = "countries/Yorkish Kingdom.txt"
LNR = "countries/LNRF.txt"
PAZ = "countries/Pazal Caliphate.txt"
ELO = "countries/Elon Musk.txt"
REM = "countries/Remanant.txt"
JUT = "countries/Jutlandia.txt"
FRO = "countries/Frog Tribe.txt"
MAG = "countries/Magyar Nomads.txt"
WBR = "countries/WBR.txt"
MTG = "countries/Montenegro.txt"
SPJ = "countries/Spronje Tribe.txt"
SHI = "countries/Shitpost Clan.txt"
GAC = "countries/Gachidemia.txt"
ADR = "countries/Andorra.txt"
BTE = "countries/BTEP.txt"
GOA = "countries/Goatland.txt"
FRC = "countries/Francenistan.txt"
PIN = "countries/Pindorama.txt"
VES = "countries/Vessel.txt"
FRE = "countries/Free Lands.txt"
NTF = "countries/Notenfunie.txt"
ARO = "countries/Aros Chiefdom.txt"
ETA = "countries/Ethana.txt"
SHA = "countries/Shadow Tribe.txt"
TRD = "countries/Trade Tribe.txt"
XXX = "countries/Unclaimed Territory.txt"